26 59 59 59 59 59 59 59 59 59 59 59 59 59 59 59 48 59 59 59 59 59 59 59 59 59 59 59 59 59 59 59 27 26 59 59 59 59 59 59 59 59 59 59 59 59 27 40 40 40 40 26 59 59 59 59 59 59 59 27
41 0 0 0 0 0 0 0 0 0 0 0 0 0 0 0 43 0 0 0 0 0 0 0 0 0 0 0 0 0 0 0 39 41 0 0 0 0 0 0 0 0 0 0 0 0 58 27 40 40 40 41 0 0 0 0 0 0 0 39
41 0 0 0 0 0 0 0 0 0 0 104 0 0 15 0 43 0 132 0 0 0 0 0 0 0 0 0 0 0 15 0 39 41 0 15 0 0 0 0 0 132 132 0 0 0 0 58 59 59 59 60 0 0 0 0 0 0 0 39 
41 0 0 0 0 0 0 0 0 0 104 0 0 95 0 0 43 104 15 104 0 0 0 0 0 104 95 104 0 132 0 104 39 41 0 0 0 0 0 0 104 0 0 104 0 0 0 0 0 0 0 0 0 0 0 0 0 0 0 39
41 0 0 0 126 0 0 0 0 104 0 0 96 97 97 97 90 0 0 0 0 0 0 0 96 97 84 22 101 101 20 21 46 49 97 97 98 0 0 0 96 97 97 98 0 0 132 0 0 0 0 0 0 0 0 126 0 0 0 39
41 0 0 0 0 0 0 0 104 0 0 0 0 0 0 0 111 97 97 98 0 0 132 0 0 0 58 102 97 97 103 59 59 60 0 0 0 0 0 0 0 0 0 0 0 0 104 0 0 0 132 0 0 0 0 0 0 0 0 39
45 21 21 21 21 22 0 0 24 0 0 0 0 0 0 0 0 0 0 0 0 0 104 0 0 0 0 0 0 0 0 0 0 0 0 0 0 0 0 0 0 132 132 0 0 0 24 0 0 0 104 0 0 0 96 97 97 97 97 29
26 59 59 59 59 60 0 0 62 0 104 0 0 0 0 0 0 0 0 0 0 0 24 0 0 0 0 0 0 0 0 0 0 0 0 0 0 0 0 0 104 0 0 104 0 0 62 0 0 0 24 0 0 0 0 0 0 0 0 39
41 0 0 0 0 0 0 0 0 0 24 0 0 0 0 132 0 0 0 0 0 0 62 0 0 0 0 0 0 0 0 0 0 0 0 0 0 0 0 0 96 97 97 98 0 0 0 0 0 0 62 0 0 0 0 0 0 132 0 39
41 0 0 132 0 0 0 0 0 0 62 0 0 0 0 104 0 0 0 0 0 0 0 0 0 0 0 0 0 0 0 0 0 0 0 0 0 0 0 0 0 0 0 0 0 0 0 0 0 0 0 0 0 0 0 0 132 0 15 39
41 0 104 15 104 0 0 0 0 0 0 0 0 0 20 21 22 104 104 132 104 104 132 104 104 20 22 0 0 132 0 0 132 0 101 20 22 0 0 0 104 132 132 104 0 0 0 0 0 0 0 0 0 0 0 132 0 0 0 39
41 0 0 0 0 0 0 0 0 132 0 132 0 0 39 40 45 21 21 21 21 21 21 21 21 46 41 104 104 95 104 104 95 104 20 46 45 22 0 0 0 0 0 0 0 0 0 95 0 95 0 0 0 0 104 0 0 20 21 46
45 21 21 21 21 22 101 101 24 101 24 101 101 20 46 40 40 40 40 40 40 40 40 40 40 40 45 21 21 21 21 21 21 21 46 40 40 41 0 0 0 0 0 0 0 101 20 21 21 21 22 101 104 104 0 0 0 39 40 40
40 40 40 40 40 45 21 21 30 21 30 21 21 46 40 40 40 40 40 40 40 40 40 40 40 40 40 40 40 40 40 40 40 40 40 40 40 45 21 21 21 21 21 21 21 21 46 40 40 40 45 21 21 21 21 21 21 46 40 40