40 40 40 40 40 40 26 59 59 59 59 59 59 59 59 59 48 59 59 59 59 59 59 59 59 59 59 59 59 59 59 59 27 26 59 59 59 59 59 59 59 59 59 59 59 59 27 40 40 40 40 26 59 59 59 59 59 59 59 27
40 40 40 40 40 40 41 0 0 0 0 0 0 0 0 0 43 0 0 0 0 0 0 0 57 0 0 0 0 0 0 0 39 41 0 0 0 0 0 0 0 0 0 0 0 0 58 27 40 40 40 41 0 0 0 0 0 0 0 39
26 59 59 59 59 59 60 0 0 0 0 0 0 0 0 0 43 0 0 0 0 0 0 0 0 0 0 0 0 0 0 0 39 41 0 0 0 0 0 0 0 0 0 0 0 0 0 58 59 59 27 41 0 0 0 0 0 0 0 39
41 0 0 0 0 0 0 0 0 0 0 0 96 97 97 97 90 0 0 0 0 0 0 0 0 0 20 83 97 98 0 0 39 49 97 97 97 98 0 0 0 0 0 0 0 0 0 0 0 0 86 60 0 0 0 0 0 0 0 39
41 0 0 0 0 0 0 0 0 0 0 0 0 0 0 0 43 0 0 0 0 0 0 0 0 0 39 41 0 0 0 0 39 41 0 0 0 0 0 0 96 97 97 98 0 0 0 0 0 0 43 0 0 0 0 0 0 0 0 39
41 0 0 0 0 0 0 0 96 98 0 0 0 0 0 0 111 97 97 97 98 0 0 0 100 0 39 41 0 0 0 0 39 41 0 0 0 0 0 0 0 0 0 0 0 0 0 0 0 0 43 0 0 0 0 0 0 0 0 39
45 21 21 21 21 22 0 0 0 0 0 0 0 0 0 0 0 0 0 0 0 0 0 0 0 0 39 41 0 0 96 97 103 60 0 0 0 0 0 0 0 0 0 0 0 0 0 96 97 97 90 0 0 19 20 21 21 21 21 46
26 59 59 59 59 60 0 0 0 0 0 96 98 0 0 0 0 0 0 0 0 0 0 100 0 0 39 41 0 0 0 0 0 0 0 0 0 0 0 0 0 2 3 0 0 0 0 0 0 0 43 0 0 0 58 59 59 59 59 27
41 0 0 0 0 0 0 0 0 0 0 0 0 0 0 0 0 0 0 0 0 0 0 0 0 0 39 41 0 0 0 0 0 0 0 0 0 0 0 0 20 21 21 22 0 0 0 0 0 0 111 98 0 0 0 0 0 0 0 39
41 0 0 0 0 0 0 96 98 0 0 0 0 0 0 0 0 0 0 0 0 100 0 0 0 0 39 49 97 98 0 0 0 0 0 0 24 0 0 0 39 40 40 41 0 0 0 0 0 0 0 0 0 0 0 0 0 0 0 39
41 0 0 0 0 0 0 0 0 0 0 0 0 0 20 21 22 0 0 0 0 0 0 0 0 0 39 41 0 0 0 0 0 0 0 20 106 0 0 0 58 59 59 60 0 0 0 24 0 0 0 0 0 96 98 0 0 0 0 39
41 0 0 0 0 0 0 0 0 0 96 98 0 0 39 40 45 21 21 21 21 21 21 21 21 21 46 41 0 0 0 0 0 0 20 46 45 22 0 0 0 0 0 0 0 0 0 105 22 0 0 0 0 0 0 0 0 0 0 39
41 0 0 0 0 0 0 0 0 0 0 0 0 0 39 40 40 40 40 40 40 40 40 40 40 40 40 45 21 21 21 21 21 21 46 40 40 41 0 0 0 0 0 0 0 0 0 39 45 22 0 0 0 0 0 0 0 20 21 46
45 21 21 21 21 21 21 21 21 21 21 21 21 21 46 40 40 40 40 40 40 40 40 40 40 40 40 40 40 40 40 40 40 40 40 40 40 45 21 21 21 21 21 21 21 21 21 46 40 45 21 21 21 21 21 21 21 46 40 40