40 40 40 40 40 26 59 59 59 59 59 59 59 59 59 59 59 59 59 59 59 59 48 59 59 59 59 59 59 59 59 59 59 59 59 59 59 27 40 40 40 26 59 59 59 59 27 26 59 59 59 59 27 26 59 59 59 59 59 27 
26 59 59 59 59 60 0 0 0 0 0 0 0 0 0 0 0 0 0 0 0 0 62 0 57 0 0 0 0 0 0 0 0 0 0 0 0 39 40 40 40 41 0 0 0 0 39 41 0 0 0 0 39 41 0 0 0 0 0 39
41 0 0 0 0 0 0 0 0 0 0 0 0 0 0 0 0 0 0 0 0 0 0 0 0 0 0 0 0 0 0 0 0 0 0 0 0 86 59 59 59 60 0 0 0 0 58 60 0 0 0 0 58 60 0 0 0 0 0 39
41 0 0 0 0 0 0 0 0 0 0 0 0 0 0 0 0 0 0 0 0 0 0 0 0 0 0 0 0 0 0 0 0 0 0 0 0 43 0 0 0 0 0 0 0 0 0 0 0 0 0 0 0 0 0 0 0 0 0 39
41 0 0 0 0 24 0 0 96 98 0 0 24 0 0 0 0 0 0 0 0 0 24 0 0 0 0 0 0 0 0 0 96 97 97 97 97 112 0 0 0 0 0 0 0 0 0 0 0 0 0 0 0 0 0 0 0 0 0 39
41 0 0 0 0 43 0 0 0 0 0 0 105 21 21 21 83 97 98 0 0 0 43 0 0 96 98 0 0 0 0 0 0 0 0 0 0 0 0 0 0 0 0 0 0 0 0 0 0 0 0 0 0 0 0 0 0 0 0 39
45 21 21 21 21 106 0 0 0 0 0 0 58 59 59 59 87 0 0 0 0 0 43 0 0 0 0 0 0 0 0 0 0 0 0 0 0 0 0 0 20 22 0 0 0 0 20 22 0 0 0 0 20 21 21 21 21 21 21 46
26 59 59 59 59 102 98 0 0 0 0 0 0 0 0 0 43 0 0 0 96 97 90 0 0 0 0 100 0 0 0 0 0 0 0 0 0 0 0 0 39 41 3 0 0 0 39 41 0 0 0 0 39 40 40 40 40 40 40 40
41 0 0 0 0 0 0 0 0 0 0 0 0 0 0 0 43 0 0 0 0 0 43 0 0 0 0 0 0 0 0 0 0 0 0 0 0 0 0 20 46 41 0 0 0 0 39 41 0 0 0 0 39 26 59 59 59 27 40 40
41 0 0 0 0 0 0 0 0 0 0 0 96 97 97 97 109 97 98 0 0 0 43 0 0 0 0 0 0 92 97 98 0 0 0 0 0 20 21 46 26 60 0 0 0 0 58 60 0 0 0 0 58 60 0 0 0 39 40 40
41 0 0 0 0 0 0 0 0 0 0 0 0 0 0 0 0 0 0 0 0 0 43 0 0 0 0 0 0 43 0 0 0 0 0 0 0 58 59 59 60 0 0 0 0 0 0 0 0 0 0 0 0 0 0 0 0 39 40 40
41 0 0 0 0 0 0 0 20 22 0 0 0 0 0 0 0 0 0 0 96 97 52 21 21 21 21 21 21 106 0 0 0 0 24 0 0 0 0 0 0 0 0 0 0 0 0 0 0 0 0 0 0 0 0 0 0 39 40 40
41 0 0 0 0 0 0 101 39 41 0 0 0 0 0 0 0 0 0 0 0 0 39 40 40 40 40 40 40 41 0 0 0 0 43 0 0 0 0 0 0 0 0 0 0 0 0 0 0 0 0 0 20 22 0 0 0 39 40 40
45 21 21 21 21 21 21 21 46 45 21 21 21 21 21 21 21 21 21 21 21 21 46 40 40 40 40 40 40 45 21 21 21 21 30 21 21 21 21 21 21 21 21 21 21 21 21 21 21 21 21 21 46 45 21 21 21 46 40 40