41, 41, 41, 41, 41, 27, 60, 60, 60, 60, 60, 60, 60, 60, 60, 60, 60, 60, 60, 60, 60, 60, 49, 60, 60, 60, 60, 60, 60, 60, 60, 60, 60, 60, 60, 60, 60, 28, 41, 41, 41, 27, 60, 60, 60, 60, 28, 27, 60, 60, 60, 60, 28, 27, 60, 60, 60, 60, 60, 28,
27, 60, 60, 60, 60, 61, 0, 0, 0, 0, 0, 0, 0, 0, 0, 0, 0, 0, 0, 0, 0, 0, 63, 0, 58, 0, 0, 0, 0, 0, 0, 0, 0, 0, 0, 0, 0, 40, 41, 41, 41, 42, 0, 0, 0, 0, 40, 42, 0, 0, 0, 0, 40, 42, 0, 0, 0, 0, 0, 40,
42, 0, 0, 0, 0, 0, 0, 0, 0, 0, 0, 0, 0, 0, 0, 0, 0, 0, 0, 0, 0, 0, 0, 0, 0, 0, 0, 0, 0, 0, 0, 0, 0, 0, 0, 0, 0, 87, 60, 60, 60, 61, 0, 0, 0, 0, 59, 61, 0, 0, 0, 0, 59, 61, 0, 0, 0, 0, 0, 40,
42, 0, 0, 0, 0, 0, 0, 0, 0, 0, 0, 0, 0, 0, 0, 0, 0, 0, 0, 0, 0, 0, 0, 0, 0, 0, 0, 0, 0, 0, 0, 0, 0, 0, 0, 0, 0, 44, 0, 0, 0, 0, 0, 0, 0, 0, 0, 0, 0, 0, 0, 0, 0, 0, 0, 0, 0, 0, 0, 40,
42, 0, 0, 0, 0, 25, 0, 0, 97, 99, 0, 0, 25, 0, 0, 0, 0, 0, 0, 0, 0, 0, 25, 0, 0, 0, 0, 0, 0, 0, 0, 0, 97, 98, 98, 98, 98, 113, 0, 0, 0, 0, 0, 0, 0, 0, 0, 0, 0, 0, 0, 0, 0, 0, 0, 0, 0, 0, 0, 40,
42, 0, 0, 0, 0, 44, 0, 0, 0, 0, 0, 0, 106, 22, 22, 22, 84, 98, 99, 0, 0, 0, 44, 0, 0, 97, 99, 0, 0, 0, 0, 0, 0, 0, 0, 0, 0, 0, 0, 0, 0, 0, 0, 0, 0, 0, 0, 0, 0, 0, 0, 0, 0, 0, 0, 0, 0, 0, 0, 40,
46, 22, 22, 22, 22, 107, 0, 0, 0, 0, 0, 0, 59, 60, 60, 60, 88, 0, 0, 0, 0, 0, 44, 0, 0, 0, 0, 0, 0, 0, 0, 0, 0, 0, 0, 0, 0, 0, 0, 0, 21, 23, 0, 0, 0, 0, 21, 23, 0, 0, 0, 0, 21, 22, 22, 22, 22, 22, 22, 47,
27, 60, 60, 60, 60, 103, 99, 0, 0, 0, 0, 0, 0, 0, 0, 0, 44, 0, 0, 0, 97, 98, 91, 0, 0, 0, 0, 101, 0, 0, 0, 0, 0, 0, 0, 0, 0, 0, 0, 0, 40, 42, 4, 0, 0, 0, 40, 42, 0, 0, 0, 0, 40, 41, 41, 41, 41, 41, 41, 41,
42, 0, 0, 0, 0, 0, 0, 0, 0, 0, 0, 0, 0, 0, 0, 0, 44, 0, 0, 0, 0, 0, 44, 0, 0, 0, 0, 0, 0, 0, 0, 0, 0, 0, 0, 0, 0, 0, 0, 21, 47, 42, 0, 0, 0, 0, 40, 42, 0, 0, 0, 0, 40, 27, 60, 60, 60, 28, 41, 41,
42, 0, 0, 0, 0, 0, 0, 0, 0, 0, 0, 0, 97, 98, 98, 98, 110, 98, 99, 0, 0, 0, 44, 0, 0, 0, 0, 0, 0, 93, 98, 99, 0, 0, 0, 0, 0, 21, 22, 47, 27, 61, 0, 0, 0, 0, 59, 61, 0, 0, 0, 0, 59, 61, 0, 0, 0, 40, 41, 41,
42, 0, 0, 0, 0, 0, 0, 0, 0, 0, 0, 0, 0, 0, 0, 0, 0, 0, 0, 0, 0, 0, 44, 0, 0, 0, 0, 0, 0, 44, 0, 0, 0, 0, 0, 0, 0, 59, 60, 60, 61, 0, 0, 0, 0, 0, 0, 0, 0, 0, 0, 0, 0, 0, 0, 0, 0, 40, 41, 41,
42, 0, 0, 0, 0, 0, 0, 0, 21, 23, 0, 0, 0, 0, 0, 0, 0, 0, 0, 0, 97, 98, 53, 22, 22, 22, 22, 22, 22, 107, 0, 0, 0, 0, 25, 0, 0, 0, 0, 0, 0, 0, 0, 0, 0, 0, 0, 0, 0, 0, 0, 0, 0, 0, 0, 0, 0, 40, 41, 41,
42, 0, 0, 0, 0, 0, 0, 0, 40, 42, 0, 0, 0, 0, 0, 0, 0, 0, 0, 0, 0, 0, 40, 41, 41, 41, 41, 41, 41, 42, 0, 0, 0, 0, 44, 0, 0, 0, 0, 0, 0, 0, 0, 0, 0, 0, 0, 0, 0, 0, 0, 0, 21, 23, 0, 0, 0, 40, 41, 41,
46, 22, 22, 22, 22, 22, 22, 22, 47, 46, 22, 22, 22, 22, 22, 22, 22, 22, 22, 22, 22, 22, 47, 41, 41, 41, 41, 41, 41, 46, 22, 22, 22, 22, 31, 22, 22, 22, 22, 22, 22, 22, 22, 22, 22, 22, 22, 22, 22, 22, 22, 22, 47, 46, 22, 22, 22, 47, 41, 41