41 41 41 41 41 41 27 60 60 60 60 60 60 60 60 60 49 60 60 60 60 60 60 60 60 60 60 60 60 60 60 60 28 27 60 60 60 60 60 60 60 60 60 60 60 60 28 41 41 41 41 27 60 60 60 60 60 60 60 28
41 41 41 41 41 41 42 0 0 0 0 0 0 0 0 0 44 0 0 0 0 0 0 0 58 0 0 0 0 0 0 0 40 42 0 0 0 0 0 0 0 0 0 0 0 0 59 28 41 41 41 42 0 0 0 0 0 0 0 40
27 60 60 60 60 60 61 0 0 0 0 0 0 0 0 0 44 0 0 0 0 0 0 0 0 0 0 0 0 0 0 0 40 42 0 0 0 0 0 0 0 0 0 0 0 0 0 59 60 60 28 42 0 0 0 0 0 0 0 40
42 0 0 0 0 0 0 0 0 0 0 0 97 98 98 98 91 0 0 0 0 0 0 0 0 0 21 84 98 99 0 0 40 50 98 98 98 99 0 0 0 0 0 0 0 0 0 0 0 0 87 61 0 0 0 0 0 0 0 40
42 0 0 0 0 0 0 0 0 0 0 0 0 0 0 0 44 0 0 0 0 0 0 101 0 0 40 42 0 0 0 0 40 42 0 0 0 0 0 0 97 98 98 99 0 0 0 0 0 0 44 0 0 0 0 0 0 0 0 40
42 0 0 0 0 0 0 0 97 99 0 0 0 0 0 0 112 98 98 98 99 0 0 0 0 0 40 42 0 0 0 0 40 42 0 0 0 0 0 0 0 0 0 0 0 0 0 0 0 0 44 0 0 0 0 0 0 0 0 40
46 22 22 22 22 23 0 0 0 0 0 0 0 0 0 0 0 0 0 0 0 0 0 0 0 0 40 42 0 0 97 98 104 61 0 0 0 0 0 0 0 0 0 0 0 0 0 97 98 98 91 0 0 20 21 22 22 22 22 47
27 60 60 60 60 61 0 0 0 0 0 97 99 0 0 0 0 0 0 0 0 0 101 0 0 0 40 42 0 0 0 0 0 0 0 0 0 0 0 0 0 3 4 0 0 0 0 0 0 0 44 0 0 0 59 60 60 60 60 28
42 0 0 0 0 0 0 0 0 0 0 0 0 0 0 0 0 0 0 0 0 0 0 0 0 0 40 42 0 0 0 0 0 0 0 0 0 0 0 0 21 22 22 23 0 0 0 0 0 0 112 99 0 0 0 0 0 0 0 40
42 0 0 0 0 0 0 97 99 0 0 0 0 0 0 0 0 0 0 0 0 0 0 0 101 0 40 50 98 99 0 0 0 0 0 0 25 0 0 0 40 41 41 42 0 0 0 0 0 0 0 0 0 0 0 0 0 0 0 40
42 0 0 0 0 0 0 0 0 0 0 0 0 0 21 22 23 0 0 0 0 0 0 0 0 0 40 42 0 0 0 0 0 0 0 21 107 0 0 0 59 60 60 61 0 0 0 25 0 0 0 0 0 97 99 0 0 0 0 40
42 0 0 0 0 0 0 0 0 0 97 99 0 0 40 41 46 22 22 22 22 22 22 22 22 22 47 42 0 0 0 0 0 0 21 47 46 23 0 0 0 0 0 0 0 0 0 106 23 0 0 0 0 0 0 0 0 0 0 40
42 0 0 0 0 0 0 0 0 0 0 0 0 0 40 41 41 41 41 41 41 41 41 41 41 41 41 46 22 22 22 22 22 22 47 41 41 42 0 0 0 0 0 0 0 0 0 40 46 23 0 0 0 0 0 0 0 21 22 47
46 22 22 22 22 22 22 22 22 22 22 22 22 22 47 41 41 41 41 41 41 41 41 41 41 41 41 41 41 41 41 41 41 41 41 41 41 46 22 22 22 22 22 22 22 22 22 47 41 46 22 22 22 22 22 22 22 47 41 41