26 59 59 59 59 59 59 59 27 26 59 59 27 40 40 40 26 59 59 59 48 59 59 59 59 59 59 59 59 59 59 59 59 59 59 59 59 27 40 40 40 26 59 59 59 59 27 26 59 59 59 59 27 26 59 59 59 59 59 27
41 0 0 0 0 0 0 0 58 60 0 0 58 59 59 59 60 0 0 0 43 0 0 0 0 0 0 0 0 0 0 0 0 0 0 0 0 39 40 40 40 41 0 0 0 0 39 41 0 0 0 0 39 41 0 0 0 0 0 39
41 0 0 0 0 0 0 0 0 0 0 0 0 0 0 0 0 0 0 0 43 0 0 0 0 132 0 0 0 0 132 0 0 0 0 0 0 58 59 59 59 60 0 0 0 0 58 60 0 0 0 0 58 60 0 0 0 1 0 39
41 0 0 0 0 0 0 0 0 0 0 0 0 0 0 0 1 0 15 0 43 0 15 3 0 104 0 0 0 0 104 0 0 0 0 0 0 0 0 0 0 0 0 0 0 0 0 0 0 0 0 0 0 0 0 0 0 0 0 39
41 0 126 0 0 0 104 0 132 132 0 104 0 0 95 0 0 0 0 0 43 0 0 0 0 0 0 104 104 0 0 0 24 0 0 0 0 0 0 0 132 132 0 0 0 0 132 132 0 0 0 0 132 132 0 0 126 0 0 39
41 0 0 0 0 0 0 104 0 0 104 0 96 97 97 97 89 97 97 97 109 97 97 98 0 0 0 96 98 0 0 0 43 0 95 0 132 0 0 0 0 0 0 0 0 0 0 0 0 0 0 0 0 0 0 0 0 0 0 39
49 97 97 97 97 98 0 0 0 0 0 0 0 0 0 0 43 0 0 0 0 0 0 0 0 0 0 0 0 0 0 0 111 97 98 0 0 104 0 0 20 22 0 0 0 0 20 22 0 0 0 0 20 21 21 21 21 21 21 46
41 0 15 0 0 0 0 0 96 98 0 0 0 3 15 0 43 0 0 0 0 0 0 0 0 0 0 0 0 0 0 0 0 0 0 0 0 0 0 0 58 60 0 0 0 0 58 60 0 0 0 0 58 59 59 59 59 27 40 40
41 0 0 0 0 0 132 0 0 0 0 0 0 0 0 0 43 0 95 0 0 0 0 0 0 0 132 0 0 0 0 0 0 0 0 0 0 24 0 0 0 0 0 0 0 0 0 0 0 0 0 0 0 0 0 0 0 39 40 40
45 21 22 0 0 104 0 104 0 0 0 0 96 97 97 97 109 97 98 0 0 0 15 0 104 0 0 0 104 0 0 0 0 0 0 95 0 43 0 0 0 0 0 0 0 0 1 0 0 0 0 0 0 0 0 0 0 39 40 40
40 40 41 0 104 0 0 0 104 0 0 0 0 0 0 0 0 0 0 0 0 0 0 0 0 0 0 0 0 1 104 0 0 0 0 96 97 112 0 0 104 104 0 0 0 0 104 104 0 0 0 0 104 104 0 3 0 39 40 40
40 40 45 21 22 101 101 101 20 22 0 0 0 132 0 2 0 132 0 0 0 20 21 22 0 0 0 0 0 0 0 0 0 0 0 0 15 0 0 0 0 0 0 0 0 0 0 0 0 0 0 0 0 0 0 15 0 39 40 40
40 40 40 40 45 21 21 21 46 41 104 104 104 95 104 104 104 95 104 104 104 39 40 41 101 101 101 20 21 21 21 21 22 0 132 0 2 0 132 0 20 22 101 101 101 101 20 22 101 101 101 101 20 22 0 0 0 39 40 40
40 40 40 40 40 40 40 40 40 45 21 21 21 21 21 21 21 21 21 21 21 46 40 45 21 21 21 46 40 40 40 40 45 21 21 21 21 21 21 21 46 45 21 21 21 21 46 45 21 21 21 21 46 45 21 21 21 46 40 40